1 10 10
4 0 0 0 0 0 2 2 2 0 20
0 1 1 1 1 1 1 1 1 0 0
0 1 8 1 0 0 1 0 0 0 1
0 0 0 1 0 0 0 0 0 1 6
0 1 1 1 0 1 0 1 0 1 6
0 0 0 1 0 1 0 1 2 1 2
1 1 0 0 0 1 0 0 0 19 0
0 0 0 1 0 0 1 1 0 1 0
120 1 0 0 0 1 0 1 0 1 1
219 1 0 0 0 1 18 1 0 118 3